111111111111111111111111111111111111111
1000KK00C0000000000000000K0000000000001
1010000001000111111110000KKC00000000001
1010000C01000000000010000K0000000000001
1011111111C00111111110000000C0000000001
1000000001C001E00000000C0000KKKK0000001
1P000000010C011111111000000000000000001
111111111111111111111111111111111111111
