1111111111111
1001000C00C01
100C011111X01
10011EP0000C1
1111111111111