1111111111111
1005000C00C01
100C011111001
1P011E00000C1
1111111111111