1111111111111
1001000C00C01
100C011111001
1P011E00KK0C1
1001010C00C01
100C011111001
1001000C00C01
100C011111001
1001000C00C01
100C011111001
1001000C00C01
1111111111111
