1111111111111
1001000C00C01
1K0C0111110K1
10011EP0000C1
1111111111111
