1111111111111
1PCCC1CCCKCE1
1111111111111