1111111111111
1001000C00C01
10KC011111001
1P0110E0000C1
1111111111111