1111111111111
1001000000001
10000111110K1
1P011E0000001
1111111111111