1111111111111
100100KC00C01
100C011111001
1P011C0E00001
1111111111111