1111111111111
10CCCCCCCCCE1
1111111111111