1111111111111
1001000C00CK1
100C011111001
10011EP0000C4
1111E11111111