1111111011111
1001000C00CK1
100C011111001
10011EP0000C1
1111111111111