1111111111111
1K1000C00C01
1000C11111001
10011EP0000C1
1111111111111