1111111111111
1K01000C00C01
100C011111001

10011EP0000C1
1111111111111