1111111111111
1PCCCCCCCCEK1
1111111111111