1111111111111
10010E0C00C01
100C011111001
1P011E00000C1
1111111111111
