111111111111111111111111111111111111111
10000000C000000000000000000000000000001
101000000100011111111000000C00000000001
1010000C0100000000001000000000000000001
1011111111C00111111110000000C0000000001
1000000001C001E00000000C000000000000001
1P000000010C011111111000000000000000001
111111111111111111111111111111111111111
