1111111111111
1001000000001
1000011111001
1P011E0000001
1111111111111