1111111111111
1001000C00C01
100C011111001
1P011CE0000C1
1111111111111