1111111111111
1PCCC1CCCCCE1
1111111111111