1111111111111
001000C00C01
100C11111001
10011EP0000C1
1111111111111