1111111111111
1001000C00C01
100C011111001
10011EP0000C1
111111111111